NO ./bonus/assets/tech.xpm42
SO ./bonus/assets/tech.xpm42
WE ./bonus/assets/tech.xpm42
EA ./bonus/assets/tech.xpm42

F 50,30,30
C 180,180,255

             1111111   
             1000001   
             10M0M01   
             1000001   
             10M0M01   
             1000001   
     1111111110M0M01   
     100000001000001   
     10M0M0M010M0M01   
     100000001000001   
     1111011110M0M01   
11111111101  1000001   
1000000110111111011111 
10000M000000000000000Z 
10000001111D1111111D11 
11D11111  101     101  
10001  1111011111110111
10N01  1000000011000001
10001  1M10001M11M101M1
11111  1000000011000001
       1M10001M11M101M1
       1000000011000001
       1010001011M101M1
       10M000M011000001
       11D1111111111111
       100000001       
       1000MMM01       
       100000001       
       111111111       
