NO ./bonus/assets/tech.xpm42
SO ./bonus/assets/tech.xpm42
WE ./bonus/assets/tech.xpm42
EA ./bonus/assets/tech.xpm42

F 220,100,0
C 225,30,0







1111111111111111111111111
1000000000110000000000001
10110000011100M0000M00001
10M100000000000000000000111111111
1111111110110000011100000000000M1
ZM000000001100000111011111D111111
11110111111111011100000010001
111101111111110111M1010M10001
1100000011M1M1011100000010001
1000M000000000001100000010001
1000M000000000001101010010001
1100000111M101011111011110N01
1111M111 111M1M1 101111010001
11111111 1111111 111111111111
